        UNCLASSIFIED U.S. Department of State Case No. F-2014-20439 Doc No. C05790013 Date: 12/31/2015



                                                                                                     RELEASE IN FULL




From:                              Adams, David S <AdamsDS@state.gov>
Sent:                              Thursday, March 29, 2012 7:06 PM
To:                                Mills, Cheryl D; Kennedy, Patrick F; Burns, William J; Nides, Thomas R; Sherman, Wendy
                                   R; Sullivan, Jacob .1
Subject:                           Nominations



All —


The Senate confirmed the following nominations this evening:


Roberta Jacobson — Assistant Secretary of State, Western Hemisphere
Elizabeth Cousens — ECOSOC
Earl Gast — USAID Assistant Administrator for Africa
Tara D. Sonenshine — Undersecretary of State for Public Diplomacy
Anne Claire Richard — Assistant Secretary of State for Population, Refugees, Migration
Robert Whitehead —Ambassador to the Togolese Republic
Larry Leon Palmer — Ambassador to St. Kitts, Nevis, Antigua, and others
Jonathan Don Farrar — Ambassador to Panama
Phyllis Marie Powers — Ambassador to Nicaragua
Nancy Powell —Ambassador to India
Gina K. Ambercrombie-Winstanley — Ambassador to Malta
Julisaa Reynoso — Ambassador to Uruguay
William Todd — Ambassador to Cambodia
Jacob Wailes — Ambassador to the Tunisian Republic
Pamela White — Ambassador to Haiti
John Christopher Stevens — Ambassador to Libya
Tracey Ann Jacobson — Ambassador to Republic of Kosovo
Kenneth Merten — Ambassador to Croatia
Mark Pekala — Ambassador to the Republic of Latvia
Richard Norland.— Ambassador to Georgia
Jeffrey Levine — Ambassador to Estonia
Frederick Barton — Assistant Secretary of State for Conflict and Stabilization Operations
Linda Thomas-Greenfield — Director General of the Foreign Service


The Senate did not confirm:
Carlos Pascual — Assistant Secretary for Energy and Resources; and
Adam Namm — Ambassador to Ecuador.


Republican Senators objected to both of these two nominations at the very last moment. We are working to find out
who and address whatever issues we need to.


Thank you to everyone who assisted in the effort to confirm these nominees. Dave




This email is UNCLASSIFIED.




        UNCLASSIFIED U.S. Department of State Case No. F-2014-20439 Doc No. C05790013 Date: 12/31/2015
